"filename", "language", "CSS", "JavaScript", "XML", "comment", "blank", "total"
"c:\Users\Gintautas\Desktop\greenhouse\src\App.css", "CSS", 33, 0, 0, 0, 6, 39
"c:\Users\Gintautas\Desktop\greenhouse\src\App.js", "JavaScript", 0, 23, 0, 0, 3, 26
"c:\Users\Gintautas\Desktop\greenhouse\src\App.test.js", "JavaScript", 0, 7, 0, 0, 2, 9
"c:\Users\Gintautas\Desktop\greenhouse\src\components\Header.js", "JavaScript", 0, 252, 0, 0, 14, 266
"c:\Users\Gintautas\Desktop\greenhouse\src\components\Routes\AdminRoute.js", "JavaScript", 0, 11, 0, 0, 3, 14
"c:\Users\Gintautas\Desktop\greenhouse\src\components\Routes\PrivateRoute.js", "JavaScript", 0, 11, 0, 0, 3, 14
"c:\Users\Gintautas\Desktop\greenhouse\src\config.js", "JavaScript", 0, 24, 0, 0, 4, 28
"c:\Users\Gintautas\Desktop\greenhouse\src\constants.js", "JavaScript", 0, 4, 0, 0, 1, 5
"c:\Users\Gintautas\Desktop\greenhouse\src\index.css", "CSS", 24, 0, 0, 0, 4, 28
"c:\Users\Gintautas\Desktop\greenhouse\src\index.js", "JavaScript", 0, 104, 0, 0, 3, 107
"c:\Users\Gintautas\Desktop\greenhouse\src\interceptors.js", "JavaScript", 0, 26, 0, 6, 4, 36
"c:\Users\Gintautas\Desktop\greenhouse\src\layouts\MainLayout.js", "JavaScript", 0, 30, 0, 0, 2, 32
"c:\Users\Gintautas\Desktop\greenhouse\src\logo.svg", "XML", 0, 0, 1, 0, 0, 1
"c:\Users\Gintautas\Desktop\greenhouse\src\pages\BackDrop.js", "JavaScript", 0, 16, 0, 0, 2, 18
"c:\Users\Gintautas\Desktop\greenhouse\src\pages\EditUser.js", "JavaScript", 0, 192, 0, 0, 12, 204
"c:\Users\Gintautas\Desktop\greenhouse\src\pages\GreenhouseControl.js", "JavaScript", 0, 503, 0, 0, 23, 526
"c:\Users\Gintautas\Desktop\greenhouse\src\pages\HumidityDay.js", "JavaScript", 0, 116, 0, 2, 9, 127
"c:\Users\Gintautas\Desktop\greenhouse\src\pages\HumidityMonth.js", "JavaScript", 0, 116, 0, 2, 10, 128
"c:\Users\Gintautas\Desktop\greenhouse\src\pages\Login.js", "JavaScript", 0, 133, 0, 0, 6, 139
"c:\Users\Gintautas\Desktop\greenhouse\src\pages\Microcontroller.js", "JavaScript", 0, 148, 0, 0, 12, 160
"c:\Users\Gintautas\Desktop\greenhouse\src\pages\Register.js", "JavaScript", 0, 139, 0, 0, 7, 146
"c:\Users\Gintautas\Desktop\greenhouse\src\pages\SoilHumidityDay.js", "JavaScript", 0, 119, 0, 2, 9, 130
"c:\Users\Gintautas\Desktop\greenhouse\src\pages\SoilHumidityMonth.js", "JavaScript", 0, 116, 0, 2, 10, 128
"c:\Users\Gintautas\Desktop\greenhouse\src\pages\TemperatureDay.js", "JavaScript", 0, 120, 0, 2, 9, 131
"c:\Users\Gintautas\Desktop\greenhouse\src\pages\TemperatureMonth.js", "JavaScript", 0, 120, 0, 2, 10, 132
"c:\Users\Gintautas\Desktop\greenhouse\src\pages\Users.js", "JavaScript", 0, 110, 0, 0, 8, 118
"c:\Users\Gintautas\Desktop\greenhouse\src\requests.js", "JavaScript", 0, 216, 0, 18, 25, 259
"c:\Users\Gintautas\Desktop\greenhouse\src\setupTests.js", "JavaScript", 0, 1, 0, 4, 1, 6
"c:\Users\Gintautas\Desktop\greenhouse\src\utils.js", "JavaScript", 0, 14, 0, 0, 2, 16
"Total", "-", 57, 2671, 1, 40, 204, 2973